%%%%%%%%%%%%%%%%%%%%%%%%%%%%%%%%%%%%%%%%%%%%%%%%%%%%%%%%%%%
%P.....%......%........................%....%....%...%....%
%..%...%...%..%..%.%%%%%%%%%%%%%%%%%...%....%....%........%
%..%...%...%..%..%.....................%.. ......%........%
%..%.......%......%..%%%%%%%%%%%%%%%%%%%....%....%........%
%..%.......%......%.........................%.........%...%
%%%%%%%%%%%%%%%%%%%%%%%%%%%%%%%%%%%%%%%%%%%%%%%%%%%%%%%%%%%