%%%%%%%%%%
%. P.....%
%%%%%%%%%%
