%%%%%%%%%%%%%%%%%%%%%%%%%%%%%%%%%%%%%%%%%%%%%
%P...............................%     G    %
%.....%........................%%%%%%%%%%%%%%
%........%.................................%%
%%%%%%%%%%%%%%%%%%%%%%%%%%%%%%%%%%%%%%%% .. %
%...........................................%
%.................%.........................%
%%%%%%%%%%%%%%%%%%%%%%%%%%%%%%%%%%%%%%%%%%%%%
