%                         %%%%%%%%%%%%%%%%%%%%%%%                          %
%                        %% P..........%....... %%                         %
%                       %%......%%%%%%%%%........%%                        %
%   %%%%%%%            %% ....%%%%............%%%%%%             %%%%%%%   %
%   %     %           %%...%%%%%%..................%%            %     %   %
%   %     %%%%%%%%%%%%%............................ %%%%%%%%%%%%%%     %   %
%   %%%%%%%%%%%%%%%%%%%%%%%%%%%%%%%%%%%%%%%%%%%%%%%%%%%%%%%%%%%%%%%%%%%%   %